XXXXXXXX
X0X XX X
X1     X
X2X X XX
X3X  XEX
X  X   X
XXXXXXXX