XXXXXXXX
X X XX X
X      X
X X X XX
X X  XEX
X  X   X
XXXXXXXX